*          ***********
*          * 1 * 2 ***
*          *   *   ***
*                    *
*                    *
**********************