*                           ************************************************
*                            * * 1 * 2 * 3 * 4 * 5 * 6 * 7 * 8 * 9 * a * b *
*                            * *   *   *   *   *   *   *   *   *   *   *   *
*                            * *   *   *   *   *   *   *   *   *   *   *   *
*                                                                          *
*                                                                          *
*                                                                    *******
***************************************                              *******
***************************************                                   c*
**************                                                       *******
**************                                                            d*
**************                                                       *******
**************       *   *   *   *   *   * *                              e*
**************       *   *   *   *   *   * *                         *******
**************       * k * j * i * h * g * *                              f*
****************************************************************************